000000000000000000000000000000000000000000000000000000000000000000000000000000000000000000000000000000000000000000000000000000000000000000000000000000
000000000000000000000000000000000000000000000000000000000000000000000000000000000000000000000000000000000000000000000000000000000000000000000000000000
000000000000000000000000000000000000000000000000000000000000000000000000000000000000000000000000000000000000000000000000000000000000000000000000000000
000000000000000000000000000000000000000000000000000000000000000000000000000000000000000000000000000000000000000000000000000000000000000000000000000000
000000000000000000000000000000000000000000000000000000000000000000000000000000000000000000000000000000000000000000000000000000000000000000000000000000
100000000000000000000000000000000000000000000000000000000000000000000000000000000000000000000000000000000000000000000000000000000000000000000000000000
100000000000000000000000000000000000000000000000000000000000000000000000000000000000000000000000000000000000000000000000000000000000000000000000000000
100000000000000000000000000000000000000000000000000000000000000000000000000000000000000000000000000000000000000000000000000000000000000000000000000000
100000000000000001001000000000000000010010010010010100000000000000000000000000000000000000000000000000000000000000000000000000000000000000000000000000
100000000000000011001100000000000000110000000000000110000000000000000000000000000000000000000000000000000000000000000000000000000000000000000000000000
100000000000000111001110000000000001110000000000000111000000000000000000000000000000000000000000000000000000000000000000000000000000000000000000000000
333333333333333333003333333333333333330000000000000333333333333333333333333333333333333333333333333333333333333333333333333333333333333333333333333333
